# Gboard Dictionary version:1
mushougong	木守宫	zh-CN	
msg	木守宫	zh-CN	
treecko	木守宫	zh-CN	
kimori	木守宫	zh-CN	
senlinxiyi	森林蜥蜴	zh-CN	
slxy	森林蜥蜴	zh-CN	
grovyle	森林蜥蜴	zh-CN	
juptile	森林蜥蜴	zh-CN	
xiyiwang	蜥蜴王	zh-CN	
xyw	蜥蜴王	zh-CN	
sceptile	蜥蜴王	zh-CN	
jukain	蜥蜴王	zh-CN	
huozhiji	火稚鸡	zh-CN	
hzj	火稚鸡	zh-CN	
torchic	火稚鸡	zh-CN	
achamo	火稚鸡	zh-CN	
lizhuangji	力壮鸡	zh-CN	
lzj	力壮鸡	zh-CN	
combusken	力壮鸡	zh-CN	
wakasyamo	力壮鸡	zh-CN	
huoyanji	火焰鸡	zh-CN	
hyj	火焰鸡	zh-CN	
blaziken	火焰鸡	zh-CN	
bursyamo	火焰鸡	zh-CN	
shuiyueyu	水跃鱼	zh-CN	
syy	水跃鱼	zh-CN	
mudkip	水跃鱼	zh-CN	
mizugorou	水跃鱼	zh-CN	
zhaoyueyu	沼跃鱼	zh-CN	
zyy	沼跃鱼	zh-CN	
marshtomp	沼跃鱼	zh-CN	
numacraw	沼跃鱼	zh-CN	
juzhaoguai	巨沼怪	zh-CN	
jzg	巨沼怪	zh-CN	
swampert	巨沼怪	zh-CN	
laglarge	巨沼怪	zh-CN	
tulangquan	土狼犬	zh-CN	
tlq	土狼犬	zh-CN	
poochyena	土狼犬	zh-CN	
pochiena	土狼犬	zh-CN	
dalangquan	大狼犬	zh-CN	
dlq	大狼犬	zh-CN	
mightyena	大狼犬	zh-CN	
guraena	大狼犬	zh-CN	
shewenxiong	蛇纹熊	zh-CN	
swx	蛇纹熊	zh-CN	
zigzagoon	蛇纹熊	zh-CN	
jiguzaguma	蛇纹熊	zh-CN	
zhichongxiong	直冲熊	zh-CN	
zcx	直冲熊	zh-CN	
linoone	直冲熊	zh-CN	
massuguma	直冲熊	zh-CN	
ciweichong	刺尾虫	zh-CN	
cwc	刺尾虫	zh-CN	
wurmple	刺尾虫	zh-CN	
kemusso	刺尾虫	zh-CN	
jiakejian	甲壳茧	zh-CN	
jkj	甲壳茧	zh-CN	
silcoon	甲壳茧	zh-CN	
karasalis	甲壳茧	zh-CN	
shouliefengdie	狩猎凤蝶	zh-CN	
slfd	狩猎凤蝶	zh-CN	
beautifly	狩猎凤蝶	zh-CN	
agehunt	狩猎凤蝶	zh-CN	
dunjijian	盾甲茧	zh-CN	
djj	盾甲茧	zh-CN	
cascoon	盾甲茧	zh-CN	
mayuld	盾甲茧	zh-CN	
dufene	毒粉蛾	zh-CN	
dfe	毒粉蛾	zh-CN	
dustox	毒粉蛾	zh-CN	
dokucale	毒粉蛾	zh-CN	
lianyetongzi	莲叶童子	zh-CN	
lytz	莲叶童子	zh-CN	
lotad	莲叶童子	zh-CN	
hassboh	莲叶童子	zh-CN	
lianmaoxiaotong	莲帽小童	zh-CN	
lmxt	莲帽小童	zh-CN	
lombre		莲帽小童	zh-CN	
hasubrero	莲帽小童	zh-CN	
yetianhetong	乐天河童	zh-CN	
ytht	乐天河童	zh-CN	
yashen	乐天河童	zh-CN	
ludicolo	乐天河童	zh-CN	
runpappa	乐天河童	zh-CN	
xiangshiguo	橡实果	zh-CN	
xsg	橡实果	zh-CN	
seedot	橡实果	zh-CN	
taneboh	橡实果	zh-CN	
changyebi	长鼻叶	zh-CN	
cyb	长鼻叶	zh-CN	
nuzleaf	长鼻叶	zh-CN	
konohana	长鼻叶	zh-CN	
jiaohuatiangou	狡猾天狗	zh-CN	
jhtg	狡猾天狗	zh-CN	
shiftry	狡猾天狗	zh-CN	
dirteng	狡猾天狗	zh-CN	
aoguyan	傲骨燕	zh-CN	
agy	傲骨燕	zh-CN	
taillow	傲骨燕	zh-CN	
subame	傲骨燕	zh-CN	
dawangyan	大王燕	zh-CN	
dwy	大王燕	zh-CN	
swellow	大王燕	zh-CN	
ohsubame	大王燕	zh-CN	
changchiou	长翅鸥	zh-CN	
cco	长翅鸥	zh-CN	
Wingull	长翅鸥	zh-CN	
camome	长翅鸥	zh-CN	
dazuiou	大嘴鸥	zh-CN	
dzo	大嘴鸥	zh-CN	
pelipper	大嘴鸥	zh-CN	
lalulasi	拉鲁拉丝	zh-CN	
llls	拉鲁拉丝	zh-CN	
ralts	拉鲁拉丝	zh-CN	
qilulian	奇鲁莉安	zh-CN	
qlla	奇鲁莉安	zh-CN	
kirlia	奇鲁莉安	zh-CN	
shanaiduo	沙奈朵	zh-CN	
snd	沙奈朵	zh-CN	
chaonengnvwang	沙奈朵	zh-CN	
gardevoir	沙奈朵	zh-CN	
sirknight	沙奈朵	zh-CN	
liuliutangqiu	溜溜糖球	zh-CN	
lltq	溜溜糖球	zh-CN	
surskit	溜溜糖球	zh-CN	
ametama	溜溜糖球	zh-CN	
yuchie	雨翅蛾	zh-CN	
yce	雨翅蛾	zh-CN	
masquerain	雨翅蛾	zh-CN	
amemoth	雨翅蛾	zh-CN	
momogu	蘑蘑菇	zh-CN	
mmg	蘑蘑菇	zh-CN	
shroomish	蘑蘑菇	zh-CN	
kinococo	蘑蘑菇	zh-CN	
douligu	斗笠菇	zh-CN	
dlg	斗笠菇	zh-CN	
breloom	斗笠菇	zh-CN	
kinogassa	斗笠菇	zh-CN	
lanrenta	懒人獭	zh-CN	
lrt	懒人獭	zh-CN	
slakoth	懒人獭	zh-CN	
namakero	懒人獭	zh-CN	
guodongyuan	过动猿	zh-CN	
gdy	过动猿	zh-CN	
vigoroth	过动猿	zh-CN	
yarukimo	过动猿	zh-CN	
qingjiawang	请假王	zh-CN	
qjw	请假王	zh-CN	
slaking	请假王	zh-CN	
sekking	请假王	zh-CN	
tujurenshi	土居忍士	zh-CN	
tjrs	土居忍士	zh-CN	
nincada	土居忍士	zh-CN	
tutinin	土居忍士	zh-CN	
tiemianrenzhe	铁面忍者	zh-CN	
tmrz	铁面忍者	zh-CN	
ninjask	铁面忍者	zh-CN	
tekkanin	铁面忍者	zh-CN	
tuokerenzhe	脱壳忍者	zh-CN	
tuoqiaorenzhe	脱壳忍者	zh-CN	
tkrz	脱壳忍者	zh-CN	
tqrz	脱壳忍者	zh-CN	
guichan	脱壳忍者	zh-CN	
shedinja	脱壳忍者	zh-CN	
nukenin	脱壳忍者	zh-CN	
guniuniu	咕妞妞	zh-CN	
gnn	咕妞妞	zh-CN	
whismur	咕妞妞	zh-CN	
gonyonyo	咕妞妞	zh-CN	
houbaodan	吼爆弹	zh-CN	
hbd	吼爆弹	zh-CN	
loudred	吼爆弹	zh-CN	
dogohmb	吼爆弹	zh-CN	
baoyinguai	爆音怪	zh-CN	
byg	爆音怪	zh-CN	
exploud	爆音怪	zh-CN	
bakuong	爆音怪	zh-CN	
muxialishi	幕下力士	zh-CN	
mxls	幕下力士	zh-CN	
makuhita	幕下力士	zh-CN	
makunoshita	幕下力士	zh-CN	
tiezhanglishi	铁掌力士	zh-CN	
tzls	铁掌力士	zh-CN	
chaoliwang	铁掌力士	zh-CN	
hariyama	铁掌力士	zh-CN	
hariteyama	铁掌力士	zh-CN	
lulili	露力丽	zh-CN	
lll	露力丽	zh-CN	
azurill	露力丽	zh-CN	
ruriri	露力丽	zh-CN	
chaobeibi	朝北鼻	zh-CN	
cbb	朝北鼻	zh-CN	
zhaobeibi	朝北鼻	zh-CN	
lixingguai	朝北鼻	zh-CN	
nosepass	朝北鼻	zh-CN	
xiangweimiao	向尾喵	zh-CN	
xwm	向尾喵	zh-CN	
skitty	向尾喵	zh-CN	
eneco	向尾喵	zh-CN	
youyamao	优雅猫	zh-CN	
yym	优雅猫	zh-CN	
delcatty	优雅猫	zh-CN	
enekororo	优雅猫	zh-CN	
gouhunyan	勾魂眼	zh-CN	
ghy	勾魂眼	zh-CN	
sableye	勾魂眼	zh-CN	
yamirami	勾魂眼	zh-CN	
dazuiwa	大嘴娃	zh-CN	
dzw	大嘴娃	zh-CN	
shuangmawei	超级大嘴娃	zh-CN	
mawile	大嘴娃	zh-CN	
kucheat	大嘴娃	zh-CN	
kekeduola	可可多拉	zh-CN	
kkdl	可可多拉	zh-CN	
aron	可可多拉	zh-CN	
cokodora	可可多拉	zh-CN	
keduola	可多拉	zh-CN	
kdl	可多拉	zh-CN	
lairon	可多拉	zh-CN	
kodora	可多拉	zh-CN	
boshikeduola	波士可多拉	zh-CN	
bskdl	波士可多拉	zh-CN	
aggron	波士可多拉	zh-CN	
bossgodora	波士可多拉	zh-CN	
mashana	玛沙那	zh-CN	
msn	玛沙那	zh-CN	
meditite	玛沙那	zh-CN	
asanan	玛沙那	zh-CN	
qialeimu	恰雷姆	zh-CN	
qlm	恰雷姆	zh-CN	
medicham	恰雷姆	zh-CN	
charem	恰雷姆	zh-CN	
luoleishou	落雷兽	zh-CN	
lls	落雷兽	zh-CN	
luoleigou	落雷兽	zh-CN	
electrike	落雷兽	zh-CN	
rakurai	落雷兽	zh-CN	
leidianshou	雷电兽	zh-CN	
lds	雷电兽	zh-CN	
leidiangou	雷电兽	zh-CN	
manectric	雷电兽	zh-CN	
livolt	雷电兽	zh-CN	
zhengdianpaipai	正电拍拍	zh-CN	
zdpp	正电拍拍	zh-CN	
plusle	正电拍拍	zh-CN	
prasle	正电拍拍	zh-CN	
fudianpaipai	负电拍拍	zh-CN	
fdpp	负电拍拍	zh-CN	
minun	负电拍拍	zh-CN	
dianyingchong	电萤虫	zh-CN	
dyc	电萤虫	zh-CN	
volbeat	电萤虫	zh-CN	
barubeat	电萤虫	zh-CN	
tiantianying	甜甜萤	zh-CN	
tty	甜甜萤	zh-CN	
illumise	甜甜萤	zh-CN	
duqiangwei	毒蔷薇	zh-CN	
dqw	毒蔷薇	zh-CN	
roselia	毒蔷薇	zh-CN	
rongshishou	溶食兽	zh-CN	
rss	溶食兽	zh-CN	
gulpin	溶食兽	zh-CN	
gokulin	溶食兽	zh-CN	
tunshishou	吞食兽	zh-CN	
tss	吞食兽	zh-CN	
swalot	吞食兽	zh-CN	
marunoom	吞食兽	zh-CN	
liyayu	利牙鱼	zh-CN	
lyy	利牙鱼	zh-CN	
carvanha	利牙鱼	zh-CN	
kibania	利牙鱼	zh-CN	
juyasha	巨牙鲨	zh-CN	
jys	巨牙鲨	zh-CN	
sharpedo	巨牙鲨	zh-CN	
samehader	巨牙鲨	zh-CN	
houhoujing	吼吼鲸	zh-CN	
hhj	吼吼鲸	zh-CN	
wailmer	吼吼鲸	zh-CN	
whalko	吼吼鲸	zh-CN	
houjingwang	吼鲸王	zh-CN	
hjw	吼鲸王	zh-CN	
wailord	吼鲸王	zh-CN	
whaloh	吼鲸王	zh-CN	
daihuotuo	呆火驼	zh-CN	
dht	呆火驼	zh-CN	
numel	呆火驼	zh-CN	
donmel	呆火驼	zh-CN	
penghuotuo	喷火驼	zh-CN	
pht	喷火驼	zh-CN	
camerupt	喷火驼	zh-CN	
bakuuda	喷火驼	zh-CN	
meitangui	煤炭龟	zh-CN	
mtg	煤炭龟	zh-CN	
torkoal	煤炭龟	zh-CN	
cotoise	煤炭龟	zh-CN	
tiaotiaozhu	跳跳猪	zh-CN	
ttz	跳跳猪	zh-CN	
spoink	跳跳猪	zh-CN	
banebū	跳跳猪	zh-CN	
pupuzhu	噗噗猪	zh-CN	
ppz	噗噗猪	zh-CN	
grumpig	噗噗猪	zh-CN	
būpig	噗噗猪	zh-CN	
huanghuangban	晃晃斑	zh-CN	
hhb	晃晃斑	zh-CN	
spinda	晃晃斑	zh-CN	
patchee	晃晃斑	zh-CN	
daeyi	大颚蚁	zh-CN	
dey	大颚蚁	zh-CN	
trapinch	大颚蚁	zh-CN	
nuckrar	大颚蚁	zh-CN	
chaoyinboyouchong	超音波幼虫	zh-CN	
cybyc	超音波幼虫	zh-CN	
chaoshengboyouchong	超音波幼虫	zh-CN	
vibrava	超音波幼虫	zh-CN	
shamoqingting	沙漠蜻蜓	zh-CN	
smqt	沙漠蜻蜓	zh-CN	
qingtinglong	沙漠蜻蜓	zh-CN	
flygon	沙漠蜻蜓	zh-CN	
ciqiuxianrenzhang	刺球仙人掌	zh-CN	
cqxrz	刺球仙人掌	zh-CN	
cacnea	刺球仙人掌	zh-CN	
sabonea	刺球仙人掌	zh-CN	
menggexianrenzhang	梦歌仙人掌	zh-CN	
mgxrz	梦歌仙人掌	zh-CN	
cacturne	梦歌仙人掌	zh-CN	
noctus	梦歌仙人掌	zh-CN	
qingmianniao	青绵鸟	zh-CN	
qmn	青绵鸟	zh-CN	
swablu	青绵鸟	zh-CN	
tyltto	青绵鸟	zh-CN	
qixiqingniao	七夕青鸟	zh-CN	
qxqn	七夕青鸟	zh-CN	
altaria	七夕青鸟	zh-CN	
tyltalis	七夕青鸟	zh-CN	
maoyouzhan	猫鼬斩	zh-CN	
myz	猫鼬斩	zh-CN	
zangoose	猫鼬斩	zh-CN	
fanshishe	饭匙蛇	zh-CN	
fss	饭匙蛇	zh-CN	
fanchishe	饭匙蛇	zh-CN	
fcs	饭匙蛇	zh-CN	
seviper	饭匙蛇	zh-CN	
habunake	饭匙蛇	zh-CN	
yueshi	月石	zh-CN	
ys	月石	zh-CN	
lunatone	月石	zh-CN	
taiyangyan	太阳岩	zh-CN	
tyy	太阳岩	zh-CN	
solrock	太阳岩	zh-CN	
niniqiu	泥泥鳅	zh-CN	
nnq	泥泥鳅	zh-CN	
barboach	泥泥鳅	zh-CN	
dojoach	泥泥鳅	zh-CN	
nianyuwang	鲶鱼王	zh-CN	
nyw	鲶鱼王	zh-CN	
whiscash	鲶鱼王	zh-CN	
namazun	鲶鱼王	zh-CN	
longxiaxiaobin	龙虾小兵	zh-CN	
lxxb	龙虾小兵	zh-CN	
corphish	龙虾小兵	zh-CN	
heigani	龙虾小兵	zh-CN	
tieaolongxia	铁螯龙虾	zh-CN	
talx	铁螯龙虾	zh-CN	
crawdaunt	铁螯龙虾	zh-CN	
shizariger	铁螯龙虾	zh-CN	
tianchengou	天秤偶	zh-CN	
tco	天秤偶	zh-CN	
baltoy	天秤偶	zh-CN	
yajilon	天秤偶	zh-CN	
nianlituou	念力土偶	zh-CN	
nlto	念力土偶	zh-CN	
nendoll	念力土偶	zh-CN	
eclaydol	念力土偶	zh-CN	
chushoubaihe	触手百合	zh-CN	
csbh	触手百合	zh-CN	
lileep	触手百合	zh-CN	
lilyla	触手百合	zh-CN	
yaolanbaihe	摇篮百合	zh-CN	
ylbh	摇篮百合	zh-CN	
cradily	摇篮百合	zh-CN	
yuradle	摇篮百合	zh-CN	
taiguyuchong	太古羽虫	zh-CN	
tgyc	太古羽虫	zh-CN	
anorith	太古羽虫	zh-CN	
anopth	太古羽虫	zh-CN	
taigukuijia	太古盔甲	zh-CN	
tgkj	太古盔甲	zh-CN	
armaldo	太古盔甲	zh-CN	
chouchouyu	丑丑鱼	zh-CN	
ccy	丑丑鱼	zh-CN	
feebas	丑丑鱼	zh-CN	
hinbass	丑丑鱼	zh-CN	
meinasi	美纳斯	zh-CN	
mns	美纳斯	zh-CN	
milotic	美纳斯	zh-CN	
milokaross	美纳斯	zh-CN	
piaofupaopao	飘浮泡泡	zh-CN	
pfpp	飘浮泡泡	zh-CN	
castform	飘浮泡泡	zh-CN	
powalen	飘浮泡泡	zh-CN	
bianyinlong	变隐龙	zh-CN	
byl	变隐龙	zh-CN	
kecleon	变隐龙	zh-CN	
kakureon	变隐龙	zh-CN	
yuanyingwawa	怨影娃娃	zh-CN	
yyww	怨影娃娃	zh-CN	
shuppet	怨影娃娃	zh-CN	
kagebouzu	怨影娃娃	zh-CN	
zuzhouwawa	诅咒娃娃	zh-CN	
zzww	诅咒娃娃	zh-CN	
banette	诅咒娃娃	zh-CN	
juppeta	诅咒娃娃	zh-CN	
yexunling	夜巡灵	zh-CN	
yxl	夜巡灵	zh-CN	
duskull	夜巡灵	zh-CN	
yomawaru	夜巡灵	zh-CN	
panghuangyeling	彷徨夜灵	zh-CN	
phyl	彷徨夜灵	zh-CN	
yemoren	彷徨夜灵	zh-CN	
dusclops	彷徨夜灵	zh-CN	
samayouru	彷徨夜灵	zh-CN	
redailong	热带龙	zh-CN	
rdl	热带龙	zh-CN	
tropius	热带龙	zh-CN	
abosuolu	阿勃梭鲁	zh-CN	
absl	阿勃梭鲁	zh-CN	
absol	阿勃梭鲁	zh-CN	
xiaoguoran	小果然	zh-CN	
xgr	小果然	zh-CN	
guoranzai	小果然	zh-CN	
wynaut	小果然	zh-CN	
sohnano	小果然	zh-CN	
xuetongzi	雪童子	zh-CN	
xtz	雪童子	zh-CN	
snorunt	雪童子	zh-CN	
yukiwarashi	雪童子	zh-CN	
bingguihu	冰鬼护	zh-CN	
bgh	冰鬼护	zh-CN	
glalie	冰鬼护	zh-CN	
onigohri	冰鬼护	zh-CN	
haibaoqiu	海豹球	zh-CN	
hbq	海豹球	zh-CN	
spheal	海豹球	zh-CN	
tamazarashi	海豹球	zh-CN	
haimoshi	海魔狮	zh-CN	
hms	海魔狮	zh-CN	
sealeo	海魔狮	zh-CN	
todoggler	海魔狮	zh-CN	
diyahaishi	帝牙海狮	zh-CN	
dyhs	帝牙海狮	zh-CN	
walrein	帝牙海狮	zh-CN	
todoseruga	帝牙海狮	zh-CN	
zhenzhubei	珍珠贝	zh-CN	
zzb	珍珠贝	zh-CN	
clamperl	珍珠贝	zh-CN	
pearlulu	珍珠贝	zh-CN	
liebanyu	猎斑鱼	zh-CN	
lby	猎斑鱼	zh-CN	
huntail	猎斑鱼	zh-CN	
yinghuayu	樱花鱼	zh-CN	
yhy	樱花鱼	zh-CN	
gorebyss	樱花鱼	zh-CN	
sakurabyss	樱花鱼	zh-CN	
gukongjiyu	古空棘鱼	zh-CN	
gkjy	古空棘鱼	zh-CN	
relicanth	古空棘鱼	zh-CN	
glanth	古空棘鱼	zh-CN	
aixinyu	爱心鱼	zh-CN	
axy	爱心鱼	zh-CN	
luvdisc	爱心鱼	zh-CN	
lovecus	爱心鱼	zh-CN	
baobeilong	宝贝龙	zh-CN	
bbl	宝贝龙	zh-CN	
bagon	宝贝龙	zh-CN	
tatsubay	宝贝龙	zh-CN	
jiakelong	甲壳龙	zh-CN	
jkl	甲壳龙	zh-CN	
shelgon	甲壳龙	zh-CN	
komoruu	甲壳龙	zh-CN	
baofeilong	暴飞龙	zh-CN	
bfl	暴飞龙	zh-CN	
baorongyuan	暴飞龙	zh-CN	
xueyifeilong	暴飞龙	zh-CN	
xveyifeilong	暴飞龙	zh-CN	
salamence	暴飞龙	zh-CN	
bohmander	暴飞龙	zh-CN	
tieyaling	铁哑铃	zh-CN	
tyl	铁哑铃	zh-CN	
beldum	铁哑铃	zh-CN	
bumbber	铁哑铃	zh-CN	
jinshuguai	金属怪	zh-CN	
jsg	金属怪	zh-CN	
metang	金属怪	zh-CN	
jujinguai	巨金怪	zh-CN	
jjg	巨金怪	zh-CN	
metagross	巨金怪	zh-CN	
leijiluoke	雷吉洛克	zh-CN	
ljlk	雷吉洛克	zh-CN	
shishenzhu	雷吉洛克	zh-CN	
shimatong	雷吉洛克	zh-CN	
regirock	雷吉洛克	zh-CN	
leijiaisi	雷吉艾斯	zh-CN	
ljas	雷吉艾斯	zh-CN	
bingshenzhu	雷吉艾斯	zh-CN	
bingmatong	雷吉艾斯	zh-CN	
regice	雷吉艾斯	zh-CN	
leijisiqilu	雷吉斯奇鲁	zh-CN	
ljsql	雷吉斯奇鲁	zh-CN	
gangshenzhu	雷吉斯奇鲁	zh-CN	
gangmatong	雷吉斯奇鲁	zh-CN	
registeel	雷吉斯奇鲁	zh-CN	
ladiyasi	拉帝亚斯	zh-CN	
ldys	拉帝亚斯	zh-CN	
hongshuidu	拉帝亚斯	zh-CN	
hongfeiji	拉帝亚斯	zh-CN	
latias	拉帝亚斯	zh-CN	
ladiousi	拉帝欧斯	zh-CN	
ldos	拉帝欧斯	zh-CN	
lanshuidu	拉帝欧斯	zh-CN	
lanfeiji	拉帝欧斯	zh-CN	
latios	拉帝欧斯	zh-CN	
gaiouka	盖欧卡	zh-CN	
gok	盖欧卡	zh-CN	
haihuangya	盖欧卡	zh-CN	
qiqishou	盖欧卡	zh-CN	
kyogre	盖欧卡	zh-CN	
kaiorga	盖欧卡	zh-CN	
guladuo	固拉多	zh-CN	
gld	固拉多	zh-CN	
gulaguai	固拉多	zh-CN	
groudon	固拉多	zh-CN	
liekongzuo	烈空坐	zh-CN	
lkz	烈空坐	zh-CN	
mumushou	烈空坐	zh-CN	
rayquaza	烈空坐	zh-CN	
jilaqi	基拉祈	zh-CN	
jlq	基拉祈	zh-CN	
xuyuanxing	基拉祈	zh-CN	
jirachi	基拉祈	zh-CN	
daiouqixisi	代欧奇希斯	zh-CN	
doqxs	代欧奇希斯	zh-CN	
waixingren	代欧奇希斯	zh-CN	
dna	代欧奇希斯	zh-CN	
deoxys	代欧奇希斯	zh-CN	
