# Gboard Dictionary version:1
qiaoyinhou	敲音猴	zh-CN	
qyh	敲音猴	zh-CN	
grookey	敲音猴	zh-CN	
sarunori	敲音猴	zh-CN	
padonghou	啪咚猴	zh-CN	
pdh	啪咚猴	zh-CN	
thwackey	啪咚猴	zh-CN	
bachinki	啪咚猴	zh-CN	
hongleijingangxing	轰擂金刚猩	zh-CN	
hljgs	轰擂金刚猩	zh-CN	
rillaboom	轰擂金刚猩	zh-CN	
goriranda	轰擂金刚猩	zh-CN	
yantuer	炎兔儿	zh-CN	
yte	炎兔儿	zh-CN	
scorbunny	炎兔儿	zh-CN	
hibani	炎兔儿	zh-CN	
tengcuxiaojiang	腾蹴小将	zh-CN	
tcxg	腾蹴小将	zh-CN	
raboot	腾蹴小将	zh-CN	
rabifutto	腾蹴小将	zh-CN	
shanyanwangpai	闪焰王牌	zh-CN	
sywp	闪焰王牌	zh-CN	
cinderace	闪焰王牌	zh-CN	
leiyanxi	泪眼蜥	zh-CN	
lyx	泪眼蜥	zh-CN	
sobble	泪眼蜥	zh-CN	
messon	泪眼蜥	zh-CN	
biansexi	变涩蜥	zh-CN	
bsx	变涩蜥	zh-CN	
drizzile	变涩蜥	zh-CN	
qianmianbiyi	千面避役	zh-CN	
qmby	千面避役	zh-CN	
inteleon	千面避役	zh-CN	
intereon	千面避役	zh-CN	
tanxinlishu	贪心栗鼠	zh-CN	
txls	贪心栗鼠	zh-CN	
skwovet	贪心栗鼠	zh-CN	
cangbaolishu	藏饱栗鼠	zh-CN	
cbls	藏饱栗鼠	zh-CN	
greedent	藏饱栗鼠	zh-CN	
zhishanque	稚山雀	zh-CN	
zsq	稚山雀	zh-CN	
rookidee	稚山雀	zh-CN	
lanya	蓝鸦	zh-CN	
ly	蓝鸦	zh-CN	
corvisquire	蓝鸦	zh-CN	
gangkaiya	钢铠鸦	zh-CN	
gky	钢铠鸦	zh-CN	
corviknight	钢铠鸦	zh-CN	
amaga	钢铠鸦	zh-CN	
suozhenchong	索侦虫	zh-CN	
szc	索侦虫	zh-CN	
blipbug	索侦虫	zh-CN	
tianzhaochong	天罩虫	zh-CN	
tzc	天罩虫	zh-CN	
dottler	天罩虫	zh-CN	
yioulupu	以欧路普	zh-CN	
yolp	以欧路普	zh-CN	
orbeetle	以欧路普	zh-CN	
touerhu	偷儿狐	zh-CN	
teh	偷儿狐	zh-CN	
nickit	偷儿狐	zh-CN	
hudadao	狐大盗	zh-CN	
hdd	狐大盗	zh-CN	
thievul	狐大盗	zh-CN	
youmianmian	幼棉棉	zh-CN	
ymm	幼棉棉	zh-CN	
gossifleur	幼棉棉	zh-CN	
baipengpeng	白蓬蓬	zh-CN	
bpp	白蓬蓬	zh-CN	
eldegoss	白蓬蓬	zh-CN	
watashiraga	白蓬蓬	zh-CN	
maobianyang	毛辫羊	zh-CN	
mby	毛辫羊	zh-CN	
wooloo	毛辫羊	zh-CN	
uru	毛辫羊	zh-CN	
maomaojiaoyang	毛毛角羊	zh-CN	
mmjy	毛毛角羊	zh-CN	
dubwool	毛毛角羊	zh-CN	
yaoyaogui	咬咬龟	zh-CN	
yyg	咬咬龟	zh-CN	
chewtle	咬咬龟	zh-CN	
baoshigui	暴噬龟	zh-CN	
bsg	暴噬龟	zh-CN	
drednaw	暴噬龟	zh-CN	
kajirigame	暴噬龟	zh-CN	
laidianwang	来电汪	zh-CN	
ldw	来电汪	zh-CN	
yamper	来电汪	zh-CN	
wanpachi	来电汪	zh-CN	
zhudianquan	逐电犬	zh-CN	
zdq	逐电犬	zh-CN	
boltund	逐电犬	zh-CN	
xiaotanzi	小炭仔	zh-CN	
xtz	小炭仔	zh-CN	
rolycoly	小炭仔	zh-CN	
tandon	小炭仔	zh-CN	
datanche	大炭车	zh-CN	
dtc	大炭车	zh-CN	
carkol	大炭车	zh-CN	
jutanshan	巨炭山	zh-CN	
jts	巨炭山	zh-CN	
coalossal	巨炭山	zh-CN	
kenguochong	啃果虫	zh-CN	
kgc	啃果虫	zh-CN	
applin	啃果虫	zh-CN	
pingguolong	苹裹龙	zh-CN	
pgl	苹裹龙	zh-CN	
flapple	苹裹龙	zh-CN	
fengmilong	丰蜜龙	zh-CN	
fml	丰蜜龙	zh-CN	
appletun	丰蜜龙	zh-CN	
shabaoshe	沙包蛇	zh-CN	
sbs	沙包蛇	zh-CN	
silicobra	沙包蛇	zh-CN	
shaluomang	沙螺蟒	zh-CN	
slm	沙螺蟒	zh-CN	
sandaconda	沙螺蟒	zh-CN	
guyueniao	古月鸟	zh-CN	
gyn	古月鸟	zh-CN	
cramorant	古月鸟	zh-CN	
cisuoyu	刺梭鱼	zh-CN	
csy	刺梭鱼	zh-CN	
arrokuda	刺梭鱼	zh-CN	
hudoujiansuo	戽斗尖梭	zh-CN	
hdjs	戽斗尖梭	zh-CN	
barraskewda	戽斗尖梭	zh-CN	
dudianying	毒电婴	zh-CN	
ddy	毒电婴	zh-CN	
toxel	毒电婴	zh-CN	
chanxianrongyuan	颤弦蝾螈	zh-CN	
cxry	颤弦蝾螈	zh-CN	
toxtricity	颤弦蝾螈	zh-CN	
shaohuogong	烧火蚣	zh-CN	
shg	烧火蚣	zh-CN	
sizzlipede	烧火蚣	zh-CN	
fenyangong	焚焰蚣	zh-CN	
fyg	焚焰蚣	zh-CN	
centiskorch	焚焰蚣	zh-CN	
quanquanxiao	拳拳蛸	zh-CN	
qqx	拳拳蛸	zh-CN	
clobbopus	拳拳蛸	zh-CN	
bazhaowushi	八爪武师	zh-CN	
bzws	八爪武师	zh-CN	
grapploct	八爪武师	zh-CN	
laibeicha	来悲茶	zh-CN	
lbc	来悲茶	zh-CN	
sinistea	来悲茶	zh-CN	
busihu	怖思壶	zh-CN	
bsh	怖思壶	zh-CN	
polteageist	怖思壶	zh-CN	
pottodesu	怖思壶	zh-CN	
mibulimu	迷布莉姆	zh-CN	
lblm	迷布莉姆	zh-CN	
hatenna	迷布莉姆	zh-CN	
tibulimu	提布莉姆	zh-CN	
tblm	提布莉姆	zh-CN	
hattrem	提布莉姆	zh-CN	
bulimuwen	布莉姆温	zh-CN	
blmw	布莉姆温	zh-CN	
monv	布莉姆温	zh-CN	
hatterene	布莉姆温	zh-CN	
daodanxiaoyao	捣蛋小妖	zh-CN	
ddxy	捣蛋小妖	zh-CN	
impidimp	捣蛋小妖	zh-CN	
beroba	捣蛋小妖	zh-CN	
zhahumo	诈唬魔	zh-CN	
zhm	诈唬魔	zh-CN	
morgrem	诈唬魔	zh-CN	
changmaojumo	长毛巨魔	zh-CN	
cmjm	长毛巨魔	zh-CN	
grimmsnarl	长毛巨魔	zh-CN	
oronge	长毛巨魔	zh-CN	
dulanxiong	堵拦熊	zh-CN	
dlx	堵拦熊	zh-CN	
obstagoon	堵拦熊	zh-CN	
tachifusaguma	堵拦熊	zh-CN	
miaotoumu	喵头目	zh-CN	
mtm	喵头目	zh-CN	
perrserker	喵头目	zh-CN	
nyaikingu	喵头目	zh-CN	
molingshanhu	魔灵珊瑚	zh-CN	
mlsh	魔灵珊瑚	zh-CN	
cursola	魔灵珊瑚	zh-CN	
sanigon	魔灵珊瑚	zh-CN	
congyoubing	葱游兵	zh-CN	
cyb	葱游兵	zh-CN	
sirfetchd	葱游兵	zh-CN	
negiganaito	葱游兵	zh-CN	
tabingrenou	踏冰人偶	zh-CN	
tbro	踏冰人偶	zh-CN	
mrrime	踏冰人偶	zh-CN	
barikooru	踏冰人偶	zh-CN	
sishenban	死神板	zh-CN	
ssb	死神板	zh-CN	
runerigus	死神板	zh-CN	
desuban	死神板	zh-CN	
xiaoxiannai	小仙奶	zh-CN	
xxn	小仙奶	zh-CN	
milcery	小仙奶	zh-CN	
mahomiru	小仙奶	zh-CN	
shuangnaixian	霜奶仙	zh-CN	
snx	霜奶仙	zh-CN	
alcremie	霜奶仙	zh-CN	
mahoippu	霜奶仙	zh-CN	
liezhenbing	列阵兵	zh-CN	
lzb	列阵兵	zh-CN	
falinks	列阵兵	zh-CN	
tairetsu	列阵兵	zh-CN	
pacahaidan	啪嚓海胆	zh-CN	
pchd	啪嚓海胆	zh-CN	
pincurchin	啪嚓海胆	zh-CN	
bachinuni	啪嚓海胆	zh-CN	
xuetunchong	雪吞虫	zh-CN	
xtc	雪吞虫	zh-CN	
snom	雪吞虫	zh-CN	
yukihami	雪吞虫	zh-CN	
xueronge	雪绒蛾	zh-CN	
xre	雪绒蛾	zh-CN	
frosmoth	雪绒蛾	zh-CN	
mosunou	雪绒蛾	zh-CN	
jushiding	巨石丁	zh-CN	
jsd	巨石丁	zh-CN	
stonjourner	巨石丁	zh-CN	
ishihenjin	巨石丁	zh-CN	
bingqie	冰砌鹅	zh-CN	
bqe	冰砌鹅	zh-CN	
eiscue	冰砌鹅	zh-CN	
korippo	冰砌鹅	zh-CN	
aiguanshi	爱管侍	zh-CN	
ags	爱管侍	zh-CN	
indeedee	爱管侍	zh-CN	
yessan	爱管侍	zh-CN	
molubeike	莫鲁贝可	zh-CN	
mlbk	莫鲁贝可	zh-CN	
morpeko	莫鲁贝可	zh-CN	
tongxiang	铜象	zh-CN	
tx	铜象	zh-CN	
cufant	铜象	zh-CN	
zoudou	铜象	zh-CN	
dawangtongxiang	大王铜象	zh-CN	
dwtx	大王铜象	zh-CN	
copperajah	大王铜象	zh-CN	
daioudou	大王铜象	zh-CN	
leiniaolong	雷鸟龙	zh-CN	
lnl	雷鸟龙	zh-CN	
dracozolt	雷鸟龙	zh-CN	
pacchiragon	雷鸟龙	zh-CN	
leiniaohaishou	雷鸟海兽	zh-CN	
lnhs	雷鸟海兽	zh-CN	
arctozolt	雷鸟海兽	zh-CN	
pacchirudon	雷鸟海兽	zh-CN	
saiyulong	鳃鱼龙	zh-CN	
syl	鳃鱼龙	zh-CN	
dracovish	鳃鱼龙	zh-CN	
uonoragon	鳃鱼龙	zh-CN	
saiyuhaishou	鳃鱼海兽	zh-CN	
syhs	鳃鱼海兽	zh-CN	
arctovish	鳃鱼海兽	zh-CN	
uonochirudon	鳃鱼海兽	zh-CN	
luganglong	铝钢龙	zh-CN	
lgl	铝钢龙	zh-CN	
duraludon	铝钢龙	zh-CN	
jurarudon	铝钢龙	zh-CN	
duolongmeixiya	多龙梅西亚	zh-CN	
dlmxy	多龙梅西亚	zh-CN	
dreepy	多龙梅西亚	zh-CN	
dorameshiya	多龙梅西亚	zh-CN	
duolongqi	多龙奇	zh-CN	
dlq	多龙奇	zh-CN	
drakloak	多龙奇	zh-CN	
doronchi	多龙奇	zh-CN	
duolongbalutuo	多龙巴鲁托	zh-CN	
dlblt	多龙巴鲁托	zh-CN	
dragapult	多龙巴鲁托	zh-CN	
doraparuto	多龙巴鲁托	zh-CN	
cangxiang	苍响	zh-CN	
cx	苍响	zh-CN	
jiangou	苍响	zh-CN	
zacian	苍响	zh-CN	
zashian	苍响	zh-CN	
zangmarante	藏玛然特	zh-CN	
zmrt	藏玛然特	zh-CN	
dungou	藏玛然特	zh-CN	
zamazenta	藏玛然特	zh-CN	
wujitaina	无极汰那	zh-CN	
wjtn	无极汰那	zh-CN	
eternatus	无极汰那	zh-CN	
xiongtudi	熊徒弟	zh-CN	
xtd	熊徒弟	zh-CN	
kubfu	熊徒弟	zh-CN	
dakuma	熊徒弟	zh-CN	
wudaoxiongshi	武道熊师	zh-CN	
wdxs	武道熊师	zh-CN	
urshifu	武道熊师	zh-CN	
uraosu	武道熊师	zh-CN	
leiguanwang	蕾冠王	zh-CN	
lgw	蕾冠王	zh-CN	
calyrex	蕾冠王	zh-CN	
badorekkusu	蕾冠王	zh-CN	
salude	萨戮德	zh-CN	
sld	萨戮德	zh-CN	
zarude	萨戮德	zh-CN	
