# Gboard Dictionary version:1
jucaoye	菊草叶	zh-CN	
jcy	菊草叶	zh-CN	
jvcaoye	菊草叶	zh-CN	
chikorita	菊草叶	zh-CN	
chikoriita	菊草叶	zh-CN	
yueguiye	月桂叶	zh-CN	
ygy	月桂叶	zh-CN	
bayleef	月桂叶	zh-CN	
bayleaf	月桂叶	zh-CN	
dazhukui	大竺葵	zh-CN	
dzk	大竺葵	zh-CN	
dajuhua	大竺葵	zh-CN	
dajvhua	大竺葵	zh-CN	
meganium	大竺葵	zh-CN	
huoqiushu	火球鼠	zh-CN	
hqs	火球鼠	zh-CN	
cyndaquil	火球鼠	zh-CN	
hinoarashi	火球鼠	zh-CN	
huoyanshu	火岩鼠	zh-CN	
hys	火岩鼠	zh-CN	
lieyanshu	火岩鼠	zh-CN	
quilava	火岩鼠	zh-CN	
magmarashi	火岩鼠	zh-CN	
huobaoshou	火暴兽	zh-CN	
hbs	火暴兽	zh-CN	
typhlosion	火暴兽	zh-CN	
bakphoon	火暴兽	zh-CN	
xiaojue	小锯鳄	zh-CN	
xiaojve	小锯鳄	zh-CN	
xje	小锯鳄	zh-CN	
totodile	小锯鳄	zh-CN	
waninoko	小锯鳄	zh-CN	
lane	蓝鳄	zh-CN	
le	蓝鳄	zh-CN	
croconaw	蓝鳄	zh-CN	
alligates	蓝鳄	zh-CN	
dalie	大力鳄	zh-CN	
dle	大力鳄	zh-CN	
feraligatr	大力鳄	zh-CN	
ordile	大力鳄	zh-CN	
weili	尾立	zh-CN	
wl	尾立	zh-CN	
sentret	尾立	zh-CN	
otachi	尾立	zh-CN	
daweili	大尾立	zh-CN	
dwl	大尾立	zh-CN	
furret	大尾立	zh-CN	
ootachi	大尾立	zh-CN	
gugu	咕咕	zh-CN	
hoothoot	咕咕	zh-CN	
hoho	咕咕	zh-CN	
maotouyeying	猫头夜鹰	zh-CN	
mtyy	猫头夜鹰	zh-CN	
noctowl	猫头夜鹰	zh-CN	
yorunozuku	猫头夜鹰	zh-CN	
bapiaochong	芭瓢虫	zh-CN	
bpc	芭瓢虫	zh-CN	
ledyba	芭瓢虫	zh-CN	
rediba	芭瓢虫	zh-CN	
anpiaochong	安瓢虫	zh-CN	
apc	安瓢虫	zh-CN	
ledian	安瓢虫	zh-CN	
redian	安瓢虫	zh-CN	
yuansizhu	圆丝蛛	zh-CN	
ysz	圆丝蛛	zh-CN	
spinarak	圆丝蛛	zh-CN	
itomaru	圆丝蛛	zh-CN	
aliduosi	阿利多斯	zh-CN	
alds	阿利多斯	zh-CN	
ariados	阿利多斯	zh-CN	
chazifu	叉字蝠	zh-CN	
czf	叉字蝠	zh-CN	
crobat	叉字蝠	zh-CN	
denglongyu	灯笼鱼	zh-CN	
dly	灯笼鱼	zh-CN	
chinchou	灯笼鱼	zh-CN	
chonchie	灯笼鱼	zh-CN	
diandengguai	电灯怪	zh-CN	
ddg	电灯怪	zh-CN	
lanturn	电灯怪	zh-CN	
lantern	电灯怪	zh-CN	
piqiu	皮丘	zh-CN	
pichu	皮丘	zh-CN	
pibaobao	皮宝宝	zh-CN	
pbb	皮宝宝	zh-CN	
cleffa	皮宝宝	zh-CN	
baobaoding	宝宝丁	zh-CN	
bbd	宝宝丁	zh-CN	
igglybuff	宝宝丁	zh-CN	
pupurin	宝宝丁	zh-CN	
bokebi	波克比	zh-CN	
bkb	波克比	zh-CN	
togepi	波克比	zh-CN	
togepy	波克比	zh-CN	
bokejigu	波克基古	zh-CN	
bkjg	波克基古	zh-CN	
togetic	波克基古	zh-CN	
togechick	波克基古	zh-CN	
tianranque	天然雀	zh-CN	
trq	天然雀	zh-CN	
natu	天然雀	zh-CN	
naty	天然雀	zh-CN	
tianranniao	天然鸟	zh-CN	
trn	天然鸟	zh-CN	
xatu	天然鸟	zh-CN	
natio	天然鸟	zh-CN	
mieliyang	咩利羊	zh-CN	
mly	咩利羊	zh-CN	
mareep	咩利羊	zh-CN	
merriep	咩利羊	zh-CN	
rongrongyang	茸茸羊	zh-CN	
rry	茸茸羊	zh-CN	
flaaffy	茸茸羊	zh-CN	
mokoko	茸茸羊	zh-CN	
dianlong	电龙	zh-CN	
dl	电龙	zh-CN	
ampharos	电龙	zh-CN	
denryu	电龙	zh-CN	
astalos	电龙	zh-CN	
raizekusu	电龙	zh-CN	
qingdianzhu	青电主	zh-CN	
boltreaver	青电主	zh-CN	
meilihua	美丽花	zh-CN	
mlh	美丽花	zh-CN	
bellossom	美丽花	zh-CN	
kireihana	美丽花	zh-CN	
malilu	玛力露	zh-CN	
mll	玛力露	zh-CN	
shuishu	玛力露	zh-CN	
marill	玛力露	zh-CN	
maril	玛力露	zh-CN	
maliluli	玛力露丽	zh-CN	
mlll	玛力露丽	zh-CN	
azumarill	玛力露丽	zh-CN	
marilli	玛力露丽	zh-CN	
shucaiguai	树才怪	zh-CN	
scg	树才怪	zh-CN	
hushuoshu	树才怪	zh-CN	
sudowoodo	树才怪	zh-CN	
usokkie	树才怪	zh-CN	
wenxiangwahuang	蚊香蛙皇	zh-CN	
wxwh	蚊香蛙皇	zh-CN	
nyorotono	蚊香蛙皇	zh-CN	
politoed	蚊香蛙皇	zh-CN	
jianzicao	毽子草	zh-CN	
jzc	毽子草	zh-CN	
hoppip	毽子草	zh-CN	
hanecco	毽子草	zh-CN	
jianzihua	毽子花	zh-CN	
jzh	毽子花	zh-CN	
skiploom	毽子花	zh-CN	
popocco	毽子花	zh-CN	
jianzimian	毽子棉	zh-CN	
jzm	毽子棉	zh-CN	
jumpluff	毽子棉	zh-CN	
watacco	毽子棉	zh-CN	
changweiguaishou	长尾怪手	zh-CN	
cwgs	长尾怪手	zh-CN	
aipom	长尾怪手	zh-CN	
eipam	长尾怪手	zh-CN	
xiangrizhongzi	向日种子	zh-CN	
xrzz	向日种子	zh-CN	
sunkern	向日种子	zh-CN	
himanuts	向日种子	zh-CN	
xiangrihuaguai	向日花怪	zh-CN	
xrhg	向日花怪	zh-CN	
sunflora	向日花怪	zh-CN	
kimawari	向日花怪	zh-CN	
qingqingting	蜻蜻蜓	zh-CN	
qqt	蜻蜻蜓	zh-CN	
yanma	蜻蜻蜓	zh-CN	
yanyanma	蜻蜻蜓	zh-CN	
wubo	乌波	zh-CN	
wb	乌波	zh-CN	
wooper	乌波	zh-CN	
upah	乌波	zh-CN	
zhaowang	沼王	zh-CN	
zw	沼王	zh-CN	
quagsire	沼王	zh-CN	
nuoh	沼王	zh-CN	
taiyangyibu	太阳伊布	zh-CN	
tyyb	太阳伊布	zh-CN	
taiyangjingling	太阳伊布	zh-CN	
riyibu	太阳伊布	zh-CN	
rijingling	太阳伊布	zh-CN	
espeon	太阳伊布	zh-CN	
eifie	太阳伊布	zh-CN	
yueliangyibu	月亮伊布	zh-CN	
ylyb	月亮伊布	zh-CN	
yueliangjingling	月亮伊布	zh-CN	
yuejingling	月亮伊布	zh-CN	
yueyibu	月亮伊布	zh-CN	
umbreon	月亮伊布	zh-CN	
blacky	月亮伊布	zh-CN	
heianya	黑暗鸦	zh-CN	
hay	黑暗鸦	zh-CN	
murkrow	黑暗鸦	zh-CN	
yamikarasu	黑暗鸦	zh-CN	
daidaiwang	呆呆王	zh-CN	
ddw	呆呆王	zh-CN	
hemawang	呆呆王	zh-CN	
slowking	呆呆王	zh-CN	
yadoking	呆呆王	zh-CN	
mengyao	梦妖	zh-CN	
my	梦妖	zh-CN	
misdreavus	梦妖	zh-CN	
muma	梦妖	zh-CN	
weizhituteng	未知图腾	zh-CN	
wztt	未知图腾	zh-CN	
unown	未知图腾	zh-CN	
guoranweng	果然翁	zh-CN	
grw	果然翁	zh-CN	
wobbuffet	果然翁	zh-CN	
sonansu	果然翁	zh-CN	
qilinqi	麒麟奇	zh-CN	
qlq	麒麟奇	zh-CN	
girafarig	麒麟奇	zh-CN	
kirinriki	麒麟奇	zh-CN	
zhenguoqiu	榛果球	zh-CN	
zgq	榛果球	zh-CN	
pineco	榛果球	zh-CN	
kunugidama	榛果球	zh-CN	
folietuosi	佛烈托斯	zh-CN	
flts	佛烈托斯	zh-CN	
forretress	佛烈托斯	zh-CN	
foretos	佛烈托斯	zh-CN	
tulongdidi	土龙弟弟	zh-CN	
tldd	土龙弟弟	zh-CN	
dunsparce	土龙弟弟	zh-CN	
nokocchi	土龙弟弟	zh-CN	
tianxie	天蝎	zh-CN	
tx	天蝎	zh-CN	
tianxue	天蝎	zh-CN	
gligar	天蝎	zh-CN	
gliger	天蝎	zh-CN	
xboxonex	天蝎	zh-CN	
dagangshe	大钢蛇	zh-CN	
dgs	大钢蛇	zh-CN	
steelix	大钢蛇	zh-CN	
haganeil	大钢蛇	zh-CN	
bulu	布鲁	zh-CN	
bl	布鲁	zh-CN	
bull	布鲁	zh-CN	
snubbull	布鲁	zh-CN	
buluhuang	布鲁皇	zh-CN	
blh	布鲁皇	zh-CN	
granbull	布鲁皇	zh-CN	
qianzhenyu	千针鱼	zh-CN	
qzy	千针鱼	zh-CN	
qwilfish	千针鱼	zh-CN	
harysen	千针鱼	zh-CN	
juqiantanglang	巨钳螳螂	zh-CN	
jvqiantanglang	巨钳螳螂	zh-CN	
jqtl	巨钳螳螂	zh-CN	
scizor	巨钳螳螂	zh-CN	
hassam	巨钳螳螂	zh-CN	
huhu	壶壶	zh-CN	
hh	壶壶	zh-CN	
shuckle	壶壶	zh-CN	
tsubotsubo	壶壶	zh-CN	
helakeluosi	赫拉克罗斯	zh-CN	
hlkls	赫拉克罗斯	zh-CN	
heracross	赫拉克罗斯	zh-CN	
heracros	赫拉克罗斯	zh-CN	
niula	狃拉	zh-CN	
nl	狃拉	zh-CN	
sneasel	狃拉	zh-CN	
nyula	狃拉	zh-CN	
xiongbaobao	熊宝宝	zh-CN	
xbb	熊宝宝	zh-CN	
teddiursa	熊宝宝	zh-CN	
himeguma	熊宝宝	zh-CN	
quanquanxiong	圈圈熊	zh-CN	
qqx	圈圈熊	zh-CN	
ursaring	圈圈熊	zh-CN	
ringuma	圈圈熊	zh-CN	
rongyanchong	熔岩虫	zh-CN	
ryc	熔岩虫	zh-CN	
slugma	熔岩虫	zh-CN	
magmag	熔岩虫	zh-CN	
rongyanwoniu	熔岩蜗牛	zh-CN	
rywn	熔岩蜗牛	zh-CN	
magcargo	熔岩蜗牛	zh-CN	
magcargot	熔岩蜗牛	zh-CN	
xiaoshanzhu	小山猪	zh-CN	
xsz	小山猪	zh-CN	
swinub	小山猪	zh-CN	
urimu	小山猪	zh-CN	
changmaozhu	长毛猪	zh-CN	
cmz	长毛猪	zh-CN	
piloswine	长毛猪	zh-CN	
inomu	长毛猪	zh-CN	
taiyangshanhu	太阳珊瑚	zh-CN	
tysh	太阳珊瑚	zh-CN	
corsola	太阳珊瑚	zh-CN	
sunnygo	太阳珊瑚	zh-CN	
tiepaoyu	铁炮鱼	zh-CN	
tpy	铁炮鱼	zh-CN	
remoraid	铁炮鱼	zh-CN	
teppouo	铁炮鱼	zh-CN	
zhangyutong	章鱼桶	zh-CN	
zyt	章鱼桶	zh-CN	
octillery	章鱼桶	zh-CN	
okutank	章鱼桶	zh-CN	
xinshiniao	信使鸟	zh-CN	
xsn	信使鸟	zh-CN	
delibird	信使鸟	zh-CN	
juchifeiyu	巨翅飞鱼	zh-CN	
jvchifeiyu	巨翅飞鱼	zh-CN	
jcfy	巨翅飞鱼	zh-CN	
mantine	巨翅飞鱼	zh-CN	
mantain	巨翅飞鱼	zh-CN	
kuijianiao	盔甲鸟	zh-CN	
kjn	盔甲鸟	zh-CN	
gangniao	盔甲鸟	zh-CN	
skarmory	盔甲鸟	zh-CN	
airmd	盔甲鸟	zh-CN	
dailubi	戴鲁比	zh-CN	
dlb	戴鲁比	zh-CN	
houndour	戴鲁比	zh-CN	
delvil	戴鲁比	zh-CN	
heilujia	黑鲁加	zh-CN	
hlj	黑鲁加	zh-CN	
houndoom	黑鲁加	zh-CN	
hellgar	黑鲁加	zh-CN	
cilongwang	刺龙王	zh-CN	
clw	刺龙王	zh-CN	
longwang	刺龙王	zh-CN	
kingdra	刺龙王	zh-CN	
xiaoxiaoxiang	小小象	zh-CN	
xxx	小小象	zh-CN	
phanpy	小小象	zh-CN	
gomazou	小小象	zh-CN	
dunjia	顿甲	zh-CN	
dj	顿甲	zh-CN	
donphan	顿甲	zh-CN	
donfan	顿甲	zh-CN	
duobianshouer	多边兽2型	zh-CN	
duobianshouerxing	多边兽2型	zh-CN	
dbse	多边兽2型	zh-CN	
dbsex	多边兽2型	zh-CN	
porygon	多边兽2型	zh-CN	
jingjiaolu	惊角鹿	zh-CN	
jjl	惊角鹿	zh-CN	
stantler	惊角鹿	zh-CN	
odoshishi	惊角鹿	zh-CN	
tutuquan	图图犬	zh-CN	
ttq	图图犬	zh-CN	
huagou	图图犬	zh-CN	
smeargle	图图犬	zh-CN	
doble	图图犬	zh-CN	
wuweixiaozi	无畏小子	zh-CN	
wwxz	无畏小子	zh-CN	
baerlang	无畏小子	zh-CN	
tyrogue	无畏小子	zh-CN	
balkie	无畏小子	zh-CN	
zhanwulang	战舞郎	zh-CN	
zwl	战舞郎	zh-CN	
kebolang	战舞郎	zh-CN	
hitmontop	战舞郎	zh-CN	
kapoerer	战舞郎	zh-CN	
michunwa	迷唇娃	zh-CN	
mcw	迷唇娃	zh-CN	
smoochum	迷唇娃	zh-CN	
muchul	迷唇娃	zh-CN	
dianjiguai	电击怪	zh-CN	
djg	电击怪	zh-CN	
dianjixiaozi	电击怪	zh-CN	
elekid	电击怪	zh-CN	
yazuibaobao	鸭嘴宝宝	zh-CN	
yzbb	鸭嘴宝宝	zh-CN	
bubihuolong	鸭嘴宝宝	zh-CN	
magby	鸭嘴宝宝	zh-CN	
buby	鸭嘴宝宝	zh-CN	
danaiguan	大奶罐	zh-CN	
dng	大奶罐	zh-CN	
miltank	大奶罐	zh-CN	
xingfudan	幸福蛋	zh-CN	
xfd	幸福蛋	zh-CN	
dadan	幸福蛋	zh-CN	
blissey	幸福蛋	zh-CN	
happinas	幸福蛋	zh-CN	
leigong	雷公	zh-CN	
lg	雷公	zh-CN	
raikou	雷公	zh-CN	
yandi	炎帝	zh-CN	
yd	炎帝	zh-CN	
entei	炎帝	zh-CN	
shuijun	水君	zh-CN	
sj	水君	zh-CN	
suicune	水君	zh-CN	
youjilasi	幼基拉斯	zh-CN	
yjls	幼基拉斯	zh-CN	
youjila	幼基拉斯	zh-CN	
larvitar	幼基拉斯	zh-CN	
yogiras	幼基拉斯	zh-CN	
shajilasi	沙基拉斯	zh-CN	
sjls	沙基拉斯	zh-CN	
shajila	沙基拉斯	zh-CN	
pupitar	沙基拉斯	zh-CN	
sanagiras	沙基拉斯	zh-CN	
banjilasi	班基拉斯	zh-CN	
bkls	班基拉斯	zh-CN	
banjila	班基拉斯	zh-CN	
tyranitar	班基拉斯	zh-CN	
bangiras	班基拉斯	zh-CN	
luoqiya	洛奇亚	zh-CN	
lqy	洛奇亚	zh-CN	
yinniao	洛奇亚	zh-CN	
lugia	洛奇亚	zh-CN	
rugia	洛奇亚	zh-CN	
fengwang	凤王	zh-CN	
fw	凤王	zh-CN	
jinniao	凤王	zh-CN	
fenghuang	凤王	zh-CN	
hooh	凤王	zh-CN	
houou	凤王	zh-CN	
shilabi	时拉比	zh-CN	
slb	时拉比	zh-CN	
xuelabi	时拉比	zh-CN	
celebi	时拉比	zh-CN	