# Gboard Dictionary version:1
halili	哈力栗	zh-CN	
hll	哈力栗	zh-CN	
nimashu	哈力栗	zh-CN	
chespin	哈力栗	zh-CN	
harimaron	哈力栗	zh-CN	
pangpanghali	胖胖哈力	zh-CN	
pphl	胖胖哈力	zh-CN	
quilladin	胖胖哈力	zh-CN	
haribogu	胖胖哈力	zh-CN	
bulikalong	布里卡隆	zh-CN	
blkl	布里卡隆	zh-CN	
chesnaught	布里卡隆	zh-CN	
brigarron	布里卡隆	zh-CN	
huohuli	火狐狸	zh-CN	
hhl	火狐狸	zh-CN	
fennekin	火狐狸	zh-CN	
fokko	火狐狸	zh-CN	
changweihuohu	长尾火狐	zh-CN	
cwhh	长尾火狐	zh-CN	
braixen	长尾火狐	zh-CN	
eruna	长尾火狐	zh-CN	
yaohuohonghu	妖火红狐	zh-CN	
yhhh	妖火红狐	zh-CN	
delphox	妖火红狐	zh-CN	
mafoxy	妖火红狐	zh-CN	
guaguapaowa	呱呱泡蛙	zh-CN	
ggpw	呱呱泡蛙	zh-CN	
froakie	呱呱泡蛙	zh-CN	
keromatsu	呱呱泡蛙	zh-CN	
guatouwa	呱头蛙	zh-CN	
gtw	呱头蛙	zh-CN	
frogadier	呱头蛙	zh-CN	
gekogashira	呱头蛙	zh-CN	
jiaherenwa	甲贺忍蛙	zh-CN	
jhrw	甲贺忍蛙	zh-CN	
renwa	甲贺忍蛙	zh-CN	
greninja	甲贺忍蛙	zh-CN	
gekkouga	甲贺忍蛙	zh-CN	
juejuetu	掘掘兔	zh-CN	
jjt	掘掘兔	zh-CN	
bunnelby	掘掘兔	zh-CN	
horubi	掘掘兔	zh-CN	
jueditu	掘地兔	zh-CN	
jdt	掘地兔	zh-CN	
diggersby	掘地兔	zh-CN	
horudo	掘地兔	zh-CN	
xiaojianque	小箭雀	zh-CN	
xjq	小箭雀	zh-CN	
fletchling	小箭雀	zh-CN	
yayakoma	小箭雀	zh-CN	
huojiamque	火箭雀	zh-CN	
hjq	火箭雀	zh-CN	
fletchinder	火箭雀	zh-CN	
hinoyakoma	火箭雀	zh-CN	
liejianying	烈箭鹰	zh-CN	
ljy	烈箭鹰	zh-CN	
talonflame	烈箭鹰	zh-CN	
fiarrow	烈箭鹰	zh-CN	
fendiechong	粉蝶虫	zh-CN	
fdc	粉蝶虫	zh-CN	
scatterbug	粉蝶虫	zh-CN	
kofukimushi	粉蝶虫	zh-CN	
fendieyong	粉蝶蛹	zh-CN	
fdy	粉蝶蛹	zh-CN	
spewpa	粉蝶蛹	zh-CN	
kofurai	粉蝶蛹	zh-CN	
caifendie	彩粉蝶	zh-CN	
cfd	彩粉蝶	zh-CN	
vivillon	彩粉蝶	zh-CN	
xiaoshishi	小狮狮	zh-CN	
xss	小狮狮	zh-CN	
litleo	小狮狮	zh-CN	
shishiko	小狮狮	zh-CN	
huoyanshi	火炎狮	zh-CN	
hys	火炎狮	zh-CN	
pyroar	火炎狮	zh-CN	
kaenjishi	火炎狮	zh-CN	
huabeibei	花蓓蓓	zh-CN	
hbb	花蓓蓓	zh-CN	
flabebe	花蓓蓓	zh-CN	
huayedi	花叶蒂	zh-CN	
hyd	花叶蒂	zh-CN	
floette	花叶蒂	zh-CN	
flaette	花叶蒂	zh-CN	
huajiefuren	花洁夫人	zh-CN	
hjfr	花洁夫人	zh-CN	
florges	花洁夫人	zh-CN	
zuoqixiaoyang	坐骑小羊	zh-CN	
zqxy	坐骑小羊	zh-CN	
skiddo	坐骑小羊	zh-CN	
meekuru	坐骑小羊	zh-CN	
zuoqishanyang	坐骑山羊	zh-CN	
zqsy	坐骑山羊	zh-CN	
gogoat	坐骑山羊	zh-CN	
wanpixiongmao	顽皮熊猫	zh-CN	
wpxm	顽皮熊猫	zh-CN	
pancham	顽皮熊猫	zh-CN	
yanchamu	顽皮熊猫	zh-CN	
liumengxiongmao	流氓熊猫	zh-CN	
lmxm	流氓熊猫	zh-CN	
pangoro	流氓熊猫	zh-CN	
goronda	流氓熊猫	zh-CN	
duolimiya	多丽米亚	zh-CN	
dlmy	多丽米亚	zh-CN	
furfrou	多丽米亚	zh-CN	
torimian	多丽米亚	zh-CN	
miaomiao	妙喵	zh-CN	
mm	妙喵	zh-CN	
espurr	妙喵	zh-CN	
nyasper	妙喵	zh-CN	
chaonengmiaomiao	超能妙喵	zh-CN	
cnmm	超能妙喵	zh-CN	
meowstic	超能妙喵	zh-CN	
nyaonikusu	超能妙喵	zh-CN	
dujianqiao	独剑鞘	zh-CN	
djq	独剑鞘	zh-CN	
honedge	独剑鞘	zh-CN	
hitotsuki	独剑鞘	zh-CN	
shuangjianqiao	双剑鞘	zh-CN	
sjq	双剑鞘	zh-CN	
doublade	双剑鞘	zh-CN	
nidangiru	双剑鞘	zh-CN	
jiandunjianguai	坚盾剑怪	zh-CN	
jdjg	坚盾剑怪	zh-CN	
guijian	坚盾剑怪	zh-CN	
aegislash	坚盾剑怪	zh-CN	
gillguard	坚盾剑怪	zh-CN	
fenxiangxiang	粉香香	zh-CN	
fxx	粉香香	zh-CN	
spritzee	粉香香	zh-CN	
shushupu	粉香香	zh-CN	
fangxiangjing	芳香精	zh-CN	
fxj	芳香精	zh-CN	
aromatisse	芳香精	zh-CN	
frefuwan	芳香精	zh-CN	
mianmianpaofu	绵绵泡芙	zh-CN	
mmpf	绵绵泡芙	zh-CN	
swirlix	绵绵泡芙	zh-CN	
peroppafu	绵绵泡芙	zh-CN	
pangtianni	胖甜妮	zh-CN	
ptn	胖甜妮	zh-CN	
slurpuff	胖甜妮	zh-CN	
perorimu	胖甜妮	zh-CN	
haolayou	好啦鱿	zh-CN	
hly	好啦鱿	zh-CN	
inkay	好啦鱿	zh-CN	
maika	好啦鱿	zh-CN	
wuzeiwang	乌贼王	zh-CN	
wzw	乌贼王	zh-CN	
malamar	乌贼王	zh-CN	
karamanero	乌贼王	zh-CN	
guijiaojiao	龟脚脚	zh-CN	
gjj	龟脚脚	zh-CN	
binacle	龟脚脚	zh-CN	
kametete	龟脚脚	zh-CN	
guizujukai	龟足巨铠	zh-CN	
gzjk	龟足巨铠	zh-CN	
barbaracle	龟足巨铠	zh-CN	
gamenodesu	龟足巨铠	zh-CN	
lalazao	垃垃藻	zh-CN	
llz	垃垃藻	zh-CN	
skrelp	垃垃藻	zh-CN	
kuzumo	垃垃藻	zh-CN	
duzaolong	毒藻龙	zh-CN	
dulamini	毒藻龙	zh-CN	
dzl	毒藻龙	zh-CN	
dragalge	毒藻龙	zh-CN	
doramidoro	毒藻龙	zh-CN	
tiebiqiangxia	铁臂枪虾	zh-CN	
tbqx	铁臂枪虾	zh-CN	
clauncher	铁臂枪虾	zh-CN	
udeppo	铁臂枪虾	zh-CN	
gangpaobixia	钢炮臂虾	zh-CN	
gpbx	钢炮臂虾	zh-CN	
clawitzer	钢炮臂虾	zh-CN	
bloster	钢炮臂虾	zh-CN	
sandianxi	伞电蜥	zh-CN	
sdx	伞电蜥	zh-CN	
helioptile	伞电蜥	zh-CN	
erikiteru	伞电蜥	zh-CN	
guangdiansanxi	光电伞蜥	zh-CN	
gdsx	光电伞蜥	zh-CN	
heliolisk	光电伞蜥	zh-CN	
elezard	光电伞蜥	zh-CN	
baobaobaolong	宝宝暴龙	zh-CN	
bbbl	宝宝暴龙	zh-CN	
tyrunt	宝宝暴龙	zh-CN	
chigorasu	宝宝暴龙	zh-CN	
guaielong	怪颚龙	zh-CN	
gel	怪颚龙	zh-CN	
tyrantrum	怪颚龙	zh-CN	
gachigorasu	怪颚龙	zh-CN	
bingxuelong	冰雪龙	zh-CN	
bxl	冰雪龙	zh-CN	
amaura	冰雪龙	zh-CN	
amarusu	冰雪龙	zh-CN	
bingxuejulong	冰雪巨龙	zh-CN	
bxjl	冰雪巨龙	zh-CN	
aurorus	冰雪巨龙	zh-CN	
amaruruga	冰雪巨龙	zh-CN	
xianziyibu	仙子伊布	zh-CN	
xzyb	仙子伊布	zh-CN	
xianzijingling	仙子伊布	zh-CN	
sylveon	仙子伊布	zh-CN	
nymphia	仙子伊布	zh-CN	
shuaijiaoyingren	摔角鹰人	zh-CN	
sjyr	摔角鹰人	zh-CN	
hawlucha	摔角鹰人	zh-CN	
ruchaburu	摔角鹰人	zh-CN	
dongdongshu	咚咚鼠	zh-CN	
dds	咚咚鼠	zh-CN	
dedenne	咚咚鼠	zh-CN	
xiaosuizhuan	小碎钻	zh-CN	
xsz	小碎钻	zh-CN	
carbink	小碎钻	zh-CN	
mereshi	小碎钻	zh-CN	
niannianbao	黏黏宝	zh-CN	
nnb	黏黏宝	zh-CN	
goomy	黏黏宝	zh-CN	
numera	黏黏宝	zh-CN	
nianmeier	黏美儿	zh-CN	
nme	黏美儿	zh-CN	
sliggoo	黏美儿	zh-CN	
numeiru	黏美儿	zh-CN	
nianmeilong	黏美龙	zh-CN	
nml	黏美龙	zh-CN	
nianmeilulong	黏美龙	zh-CN	
goodra	黏美龙	zh-CN	
numerugon	黏美龙	zh-CN	
yuequaner	钥圈儿	zh-CN	
yqe	钥圈儿	zh-CN	
klefki	钥圈儿	zh-CN	
cleffy	钥圈儿	zh-CN	
xiaomuling	小木灵	zh-CN	
xml	小木灵	zh-CN	
phantump	小木灵	zh-CN	
bokurei	小木灵	zh-CN	
xiumuyao	朽木妖	zh-CN	
xmy	朽木妖	zh-CN	
trevenant	朽木妖	zh-CN	
orotto	朽木妖	zh-CN	
nanguajing	南瓜精	zh-CN	
ngj	南瓜精	zh-CN	
pumpkaboo	南瓜精	zh-CN	
bakettya	南瓜精	zh-CN	
nanguaguairen	南瓜怪人	zh-CN	
nggr	南瓜怪人	zh-CN	
gourgeist	南瓜怪人	zh-CN	
pumpjin	南瓜怪人	zh-CN	
bingbao	冰宝	zh-CN	
bb	冰宝	zh-CN	
bergmite	冰宝	zh-CN	
kachikoru	冰宝	zh-CN	
bingyanguai	冰岩怪	zh-CN	
byg	冰岩怪	zh-CN	
avalugg	冰岩怪	zh-CN	
crebase	冰岩怪	zh-CN	
wengfu	嗡蝠	zh-CN	
wf	嗡蝠	zh-CN	
noibat	嗡蝠	zh-CN	
onbatto	嗡蝠	zh-CN	
yinbolong	音波龙	zh-CN	
ybl	音波龙	zh-CN	
noivern	音波龙	zh-CN	
onvern	音波龙	zh-CN	
zheerniyasi	哲尔尼亚斯	zh-CN	
zenys	哲尔尼亚斯	zh-CN	
xerneas	哲尔尼亚斯	zh-CN	
yipeiertaer	伊裴尔塔尔	zh-CN	
ypete	伊裴尔塔尔	zh-CN	
yveltal	伊裴尔塔尔	zh-CN	
jigeerde	基格尔德	zh-CN	
jged	基格尔德	zh-CN	
zygarde	基格尔德	zh-CN	
dianxi	蒂安希	zh-CN	
dax	蒂安希	zh-CN	
diancie	蒂安希	zh-CN	
hupa	胡帕	zh-CN	
hp	胡帕	zh-CN	
huba	胡帕	zh-CN	
hoopa	胡帕	zh-CN	
boerkainien	波尔凯尼恩	zh-CN	
bekne	波尔凯尼恩	zh-CN	
volcanion	波尔凯尼恩	zh-CN	